111111111111111111111111111111111111
10P0000C0000010000000000000000000001
100000000000010000000000000000000001
100C00000000010000000000000000000001
100000000000110000000000X00000000001
1000000000000000000000000000E0000001
100000000000000000X00000000000000001
10000000000X000000000000000000000001
1000000000000000000000C0000000000001
111111111111111111111111111111111111