11111111111111111111111111111111111111111111111111111111111111111
10P0000C000001000000000000000000100000000000000000000000000000001
10000000000001000000000000000000100000000000000000000000000000001
100C000000000100000000000000000010000000000000000000000000E000001
10000000000011000000000000000000000000000000000000000000000000001
10000000000000000000000000000000000000000000000000000000000000001
10000000000000000000000000000000100000000000000000000000000000001
10000000000000000000000000000000100000000000000000000000000000001
10000000000000000000000000000000100000000000000000000000000000001
11111111111111111111111111111111111111111111111111111111111111111