11111111111111111
10C00000C00000001
11100000000000001
11000000011100011
11111111111111111